B B B - - - - B B B B B B B B B
B B B - - - - B B - - - - B B B
B B B - - - - B - - - - - - - B
B B B - - - - B - - - - - - - -
B B B B - - - B - - - - - - - -
B B B B - - - - - - - - - - - -
B B B B - - - - - - - - - B - -
B B B B ^ ^ - - - - - - ^ B - -
- - - B B B - - - - - - B B - -
- - - - - - - - - - - - - B - -
- - - - - - - - - - - - - - - -
- - - - - - - - - - - - - - - -
- - - - - - - - - - - - - - - -
- * - - - - - - - - - - - - - -
- B - - - F F - - - F F - - - -
- B - - - - - - - - - - - - - -